8.ox
...ooo..
o..o....
oooo.o..
o.....oo
.o...oo.
o....o..
oo......
......oo
