20.ox
oo..................
o....o......o......o
..o...o..o....o.....
.o....o.o.o....o.o..
........o...o.......
......oo.........oo.
....................
.....o.............o
...oo.o...o.........
.............o...oo.
.....o...o..........
..........o.........
...o.......o....o...
.o...........o......
.......o....o.......
.oo.................
..........o.........
.o..o......o..ooo..o
.....o.....o...o.o..
o...................
