43.ox
...ooo..........o..........................
....................o.................o....
........o.............o.......o..o.........
...o.......................................
.......o.................o......o..........
.......o.....o.............................
...........o....o..........................
..........o.................o....o.........
..o........o......................o........
...o.........o.....o.....oo...o..o.........
..o........................................
..................o......o.................
................o...........o....o.........
....o......................................
...........................................
o.o...........o...........................o
................................o.......oo.
..................................o........
......o......................o....o..o.o...
..............o...o.................o...o..
.....o....o................................
...........o..........o....................
o..........................................
....o......................................
................o...............o.........o
............o.................o............
...o.......................................
.....................................o.....
..............o...................o........
...................oo....oo................
.....o........o....o.......................
..oo..................................o....
.........o...............................o.
...................o..................o....
.................o.............o...........
...................o.............o.........
..................................oo...o..o
...................o..ooo..........o.......
...........................................
..........................oo..........o....
........................o..........oo......
...................o..o......o........oo...
..o..................o...........o.........
