25.ox
...................oo....
........................o
.o...............o.......
......o.......o..........
.o...o........o..........
....oo........o...o..o...
..................o......
.........o.........o..o..
o..........o.........o...
..o...o.......o.....oo...
........................o
.........................
...........o.......oo....
..............o.o........
.o.....o................o
.......o.....oo.........o
....o................o...
....ooo..................
.oo....o.....oo..........
o........................
o....................o...
.o.......oo.o..o.........
..o.................o....
o........................
..........o......o.......
